30
30
555,555,555,555,555,555,555,555,555,555,555,555,555,555,555,555,555,555,555,555,555,555,555,555,555,555,555,555,555,555
555,555,555,555,555,555,555,555,555,555,555,555,555,555,555,555,555,555,555,555,555,555,555,555,555,555,555,555,555,555
555,-147,-148,-149,-148,-149,-148,-149,-148,-149,-148,-149,-148,-149,-148,-149,-148,-149,-148,-149,-148,-149,-148,-149,-148,-149,-148,-149,-150,555
555,-170,-171,-172,-171,-172,-171,-172,-171,-172,-171,-172,-171,-172,-171,-172,-171,-172,-171,-172,-171,-172,-171,-172,-171,-172,-171,-172,-173,555
555,555,555,555,555,555,555,555,555,555,555,555,555,555,555,555,555,555,555,555,555,555,555,555,555,555,555,555,555,555
555,555,555,555,555,555,555,555,555,555,555,555,555,555,555,555,555,555,555,555,555,555,555,555,555,555,555,555,555,555
555,555,555,555,555,555,555,555,555,555,555,555,555,555,555,555,555,555,555,555,555,555,555,555,555,555,555,555,555,555
555,555,555,555,555,555,555,555,555,555,555,555,555,555,555,555,555,555,555,555,555,555,555,555,555,555,555,555,555,555
555,555,555,555,555,555,555,555,555,555,555,555,555,555,555,555,555,555,555,555,555,555,555,555,555,555,555,555,555,555
555,555,555,555,555,555,555,555,555,555,555,555,555,555,555,555,555,555,555,555,555,555,555,555,555,555,555,555,555,555
555,555,555,555,555,555,555,555,555,555,555,555,555,555,555,555,555,555,555,555,555,555,555,555,555,555,555,555,555,555
555,-147,-148,-149,-148,-149,-148,-149,-150,555,-147,-148,-148,-149,-150,555,555,555,555,555,555,555,555,555,555,555,555,555,555,555
555,-170,-171,-172,-171,-172,-171,-172,-173,555,-170,-171,-171,-172,-173,555,555,555,555,555,555,555,555,555,555,555,555,555,555,555
555,555,555,555,555,555,555,555,555,555,555,555,555,555,555,555,555,555,555,555,555,555,555,555,555,555,555,555,555,555
555,555,555,555,555,555,555,555,555,555,555,555,555,555,555,555,555,555,555,555,555,555,555,555,555,555,555,555,555,555
555,555,555,555,555,555,555,555,555,555,555,555,555,555,555,555,555,555,555,555,555,555,555,555,555,555,555,555,555,555
555,555,555,555,555,555,555,555,555,555,555,555,555,555,555,555,555,555,555,555,555,555,555,555,555,555,555,555,555,555
555,-147,-148,-148,-149,-150,555,555,555,555,-147,-148,-149,-148,-149,-150,555,555,555,555,555,555,555,555,555,555,555,555,555,555
555,-170,-171,-171,-172,-173,555,555,555,555,-170,-171,-172,-171,-172,-173,555,555,555,555,555,555,555,555,555,555,555,555,555,555
555,555,555,555,555,555,555,555,555,555,555,555,555,555,555,555,555,555,555,555,555,555,555,555,555,555,555,555,555,555
555,555,555,555,555,555,555,555,555,555,555,555,555,555,555,555,555,555,555,555,555,555,555,555,555,555,555,555,555,555
555,555,555,555,555,555,555,555,555,555,555,555,555,555,555,555,555,555,555,555,555,555,555,555,555,555,555,555,555,555
555,555,555,555,555,555,555,555,555,555,555,555,555,555,555,555,555,555,555,555,555,555,555,555,555,555,555,555,555,555
555,555,555,555,-147,-148,-148,-149,-150,555,555,555,555,555,555,555,555,555,555,555,555,555,555,555,555,555,555,555,555,555
555,555,555,555,-170,-171,-171,-172,-173,555,555,555,555,555,555,555,555,555,555,555,555,555,555,555,555,555,555,555,555,555
555,555,555,555,555,555,555,555,555,555,555,555,555,555,555,555,555,555,555,555,555,555,555,555,555,555,555,555,555,555
555,555,555,555,555,555,555,555,555,555,555,555,555,555,555,555,555,555,555,555,555,555,555,555,555,555,555,555,555,555
555,555,555,555,555,555,555,555,555,555,555,555,555,555,555,555,555,555,555,555,555,555,555,555,555,555,555,555,555,555
555,555,555,555,555,555,555,555,555,555,555,555,555,555,555,555,555,555,555,555,555,555,555,555,555,555,555,555,555,555
555,555,555,555,555,555,555,555,555,555,555,555,555,555,555,555,555,555,555,555,555,555,555,555,555,555,555,555,555,555
