30
30
-3,-144,-144,-144,-144,-144,-144,-144,-144,-144,-144,-144,-144,-144,-144,-144,-144,-144,-144,-144,-144,-144,-144,-144,-144,-144,-144,-144,-144,-4
-69,-124,-125,-126,-126,-126,-126,-126,-126,-126,-126,-126,-126,-126,-126,-126,-126,-126,-126,-126,-126,-126,-126,-125,-126,-126,-126,-126,-127,-69
-69,555,555,555,555,555,555,555,555,555,555,555,555,555,555,555,555,555,555,555,555,555,555,555,555,555,555,555,555,-69
-69,555,555,555,555,555,555,555,555,555,555,555,555,555,555,555,555,555,555,555,555,555,555,555,555,555,555,555,555,-69
-69,555,555,555,555,555,555,555,555,555,555,555,555,555,555,555,555,555,555,555,555,555,555,555,555,555,555,555,555,-69
-69,555,555,555,555,555,555,555,555,555,555,555,555,555,555,555,555,555,555,555,555,555,555,555,555,555,555,555,555,-69
-69,555,555,555,555,555,555,555,555,555,555,555,555,555,555,555,555,555,555,555,555,555,555,555,555,555,555,555,555,-69
-69,555,555,555,555,555,555,555,555,555,555,555,555,555,555,555,555,555,555,555,555,555,555,555,555,555,555,555,555,-69
-69,555,555,555,555,555,555,555,555,555,555,555,555,555,555,555,555,555,555,555,555,555,555,555,555,555,555,555,555,-69
-69,555,555,555,555,555,555,555,555,555,555,555,555,555,555,555,555,555,555,555,555,555,555,555,555,555,555,555,555,-69
-69,-144,-144,-144,-144,-144,-144,-144,-144,-144,-144,-4,555,555,555,555,555,555,555,555,555,555,555,555,555,555,555,555,555,-69
-69,-124,-125,-126,-125,-126,-125,-126,-125,-125,-126,-69,555,555,555,555,555,555,555,555,555,555,555,555,555,555,555,555,555,-69
-69,555,555,555,555,555,555,555,555,555,555,-69,555,555,555,555,555,555,555,555,555,555,555,555,555,555,555,555,555,-69
-69,555,555,555,555,555,555,555,555,555,555,-69,555,555,555,555,555,555,555,555,555,555,555,555,555,555,555,555,555,-69
-69,555,555,555,555,555,555,555,555,555,555,-69,555,555,555,555,555,555,555,555,555,555,555,555,555,555,555,555,555,-69
-69,555,555,555,555,555,555,555,555,555,555,-69,555,555,555,555,555,555,555,555,555,555,555,555,555,555,555,555,555,-69
-69,555,555,555,555,555,555,555,555,555,555,-69,555,555,555,555,555,555,555,555,555,555,555,555,555,555,555,555,555,-69
-69,555,555,555,555,555,555,555,555,555,555,-69,555,555,555,555,555,555,555,555,555,555,555,555,555,555,555,555,555,-69
-69,555,555,555,555,555,-3,-144,-144,-144,-144,-144,-144,-144,-144,-144,-144,-144,-144,-144,-144,-144,-144,-145,555,555,555,555,555,-69
-69,555,555,555,555,555,-69,-124,-125,-126,-125,-126,-125,-126,-125,-126,-125,-126,-125,-126,-125,-126,-126,-127,555,555,555,555,555,-69
-69,555,555,555,555,555,-69,555,555,555,555,555,555,555,555,555,555,555,555,555,555,555,555,555,555,555,555,555,555,-69
-69,555,555,555,555,555,-69,555,555,555,555,555,555,555,555,555,555,555,555,555,555,555,555,555,555,555,555,555,555,-69
-69,-144,-144,-144,-144,-144,-27,555,555,555,555,555,555,555,555,555,555,555,555,555,555,555,555,555,555,555,555,555,555,-69
-69,-124,-125,-126,-125,-126,-127,555,555,555,555,555,555,555,555,555,555,555,555,555,555,555,555,555,555,555,555,555,555,-69
-69,555,555,555,555,555,555,555,555,555,555,555,555,555,555,555,555,555,555,555,555,555,555,555,555,555,555,555,555,-69
-69,555,555,555,555,555,555,555,555,555,555,555,555,555,555,555,555,555,555,555,555,555,555,555,555,555,555,555,555,-69
-69,555,555,555,555,555,555,555,555,555,555,555,555,555,555,555,555,555,555,555,555,555,555,555,555,555,555,555,555,-69
-69,555,555,555,555,555,555,555,555,555,555,555,555,555,555,555,555,555,555,555,555,555,555,555,555,555,555,555,555,-69
-69,555,555,555,555,555,555,555,555,555,555,555,555,555,555,555,555,555,555,555,555,555,555,555,555,555,555,555,555,-69
-26,-144,-144,-144,-144,-144,-144,-144,-144,-144,-144,-144,-144,-144,-144,-144,-144,-144,-144,-144,-144,-144,-144,-144,-144,-144,-144,-144,-144,-27
