45
45
-195,-282,-282,-282,-282,-282,-282,-282,-282,-282,-282,-282,-282,-282,-282,-282,-282,-282,-282,-282,-282,-282,-282,-282,-282,-282,-282,-282,-282,-282,-282,-282,-282,-282,-282,-282,-282,-282,-282,-282,-282,-282,-282,-282,196
-261,-124,-125,-125,-125,-125,-125,-125,-125,-125,-125,-125,-125,-125,-125,-125,-125,-125,-125,-125,-125,126,-125,-125,-125,-125,-125,-125,-125,-125,126,-125,-125,-125,-125,-125,-125,-125,-125,-125,126,-125,-125,127,-261
-261,-147,-148,-148,-148,-148,-148,-148,-148,-148,-148,-148,-148,-148,-148,-148,-148,-148,-148,-148,-148,149,-148,-148,-148,-148,-148,-148,-148,-148,149,-148,-148,-148,-148,-148,-148,-148,-148,-148,149,-148,-148,150,-261
-261,-170,-171,-171,-171,-171,-171,-171,-171,-171,-171,-171,-171,-171,-171,-171,-171,-171,-171,-171,-171,-172,-171,-171,-171,-171,-171,-171,-171,-171,-172,-171,-171,-171,-171,-171,-171,-171,-171,-171,-172,-171,-171,-173,-261
-261,555,555,555,555,555,555,555,555,555,555,555,555,555,555,555,555,555,555,555,555,555,555,555,555,555,555,555,555,555,555,555,555,555,555,555,555,555,555,555,555,555,555,555,-261
-261,555,555,555,555,555,555,555,555,555,555,555,555,555,555,555,555,555,555,555,555,555,555,555,555,555,555,555,555,555,555,555,555,555,555,555,555,555,555,555,555,555,555,555,-261
-261,555,555,555,555,555,555,555,555,555,555,555,555,555,555,555,555,555,555,555,555,555,555,555,555,555,555,555,555,555,555,555,555,555,555,555,555,555,555,555,555,555,555,555,-261
-261,555,555,555,555,555,555,555,555,555,555,555,555,555,555,555,555,555,555,555,555,555,555,555,555,555,555,555,555,555,555,555,555,555,555,555,555,555,555,555,555,555,555,555,-261
-261,555,555,555,555,-195,-236,-190,-190,-190,-190,-190,-190,-190,-190,-190,196,555,555,555,555,555,-195,-236,-236,-236,-236,-236,-236,-236,-236,196,555,555,555,555,555,555,555,555,555,555,555,555,-261
-261,555,555,555,555,-77,-124,-125,126,126,126,126,126,-125,126,127,-261,555,555,555,555,555,-261,-124,-125,126,-125,126,-125,126,127,-261,555,555,555,555,555,555,555,555,555,555,555,555,-261
-261,555,555,555,555,-77,-147,-148,149,149,149,149,149,-148,149,150,-261,555,555,555,555,555,-261,-147,-148,149,-148,149,-148,149,150,-261,555,555,555,555,555,555,555,555,555,555,555,555,-261
-261,555,555,555,555,-77,-170,-171,-172,-172,-172,-172,-172,-171,-172,-173,-261,555,555,555,555,555,-261,-170,-171,-172,-171,-172,-171,-172,-173,-261,555,555,555,555,555,555,555,555,555,555,555,555,-261
-261,555,555,555,555,-77,555,555,555,555,555,555,555,555,555,555,-261,555,555,555,555,555,-261,555,555,555,555,555,555,555,555,-261,555,555,555,555,555,555,555,555,555,555,555,555,-261
-261,555,555,555,555,-77,555,555,555,555,555,555,555,555,555,555,218,-190,-190,-190,-190,-190,-219,555,555,555,555,555,555,555,555,-261,555,555,555,555,555,555,555,555,555,555,555,555,-261
-261,555,555,555,555,-77,555,555,555,555,555,555,555,555,555,555,-124,126,126,126,126,126,127,555,555,555,555,555,555,555,555,-261,555,555,555,555,555,555,555,555,555,555,555,555,-261
-261,555,555,555,555,-77,555,555,555,555,555,555,555,555,555,555,-147,149,149,149,149,149,150,555,555,555,555,555,555,555,555,-261,555,555,555,555,555,555,555,555,555,555,555,555,-261
-261,555,555,555,555,-77,555,555,555,555,555,555,555,555,555,555,-170,-172,-172,-172,-172,-172,-173,555,555,555,555,555,555,555,555,-261,555,555,555,555,555,555,555,555,555,555,555,555,-261
-261,555,555,555,555,-77,555,555,555,555,555,555,555,555,555,555,555,555,555,555,555,555,555,555,555,555,555,555,555,555,555,-261,555,555,555,555,555,555,555,555,555,555,555,555,-261
-261,-190,-190,-190,-190,211,555,555,555,555,555,555,555,555,555,555,555,555,555,555,555,555,555,555,555,555,555,555,555,555,555,-261,555,555,555,555,555,555,555,555,555,555,555,555,-261
-261,-124,-125,-125,126,127,555,555,555,555,54,555,555,555,555,555,555,555,555,555,555,555,555,555,54,555,555,555,555,555,555,-261,555,555,555,555,555,555,555,555,555,555,555,555,-261
-261,-147,-148,-148,149,150,555,555,555,555,-77,555,555,555,555,555,555,555,555,555,555,555,555,555,-77,555,555,555,555,555,555,-261,555,555,555,555,555,555,555,555,555,555,555,555,-261
-261,-170,-171,-171,-172,-173,555,555,555,555,-77,555,555,555,555,555,555,555,555,555,555,555,555,555,-77,555,555,555,555,555,555,-261,555,555,555,555,555,555,555,555,555,555,555,555,-261
-261,555,555,555,555,555,555,555,555,555,-77,555,555,555,555,555,555,555,555,555,555,555,555,555,-77,555,555,555,555,555,555,-261,555,555,555,555,555,555,555,555,555,555,555,555,-261
-261,555,555,555,555,555,555,555,555,555,34,144,144,144,144,144,144,144,144,144,144,144,144,144,35,555,555,555,555,555,555,-261,555,555,555,555,555,555,555,555,555,555,555,555,-261
-261,555,555,555,555,555,555,555,555,555,-147,-148,-148,-148,-148,-148,-148,-148,-148,-148,-148,-148,-148,-149,-150,555,555,555,555,555,555,-261,555,555,555,555,555,555,555,555,555,555,555,555,-261
-261,555,555,555,555,555,555,555,555,555,-170,-171,-171,-171,-171,-171,-171,-171,-171,-171,-171,-171,-171,-172,-173,555,555,555,555,555,555,-261,555,555,555,555,555,555,555,555,555,555,555,555,-261
-261,555,555,555,555,555,555,555,555,555,555,555,555,555,555,555,555,555,555,555,555,555,555,555,555,555,555,555,555,555,555,-261,555,555,555,555,555,555,555,555,555,555,555,555,-261
-261,555,555,555,555,555,555,555,555,555,555,555,555,555,555,555,555,555,555,555,555,555,555,555,555,555,555,555,555,555,555,-261,555,555,555,555,555,555,555,555,555,555,555,555,-261
-261,555,555,555,555,555,555,555,555,555,555,555,555,555,555,555,555,555,555,555,555,555,555,555,555,555,555,555,555,555,555,-261,555,555,555,555,555,555,555,555,555,555,555,555,-261
-261,555,555,555,555,555,555,555,555,555,555,555,555,555,555,555,555,555,555,555,555,555,555,555,555,555,555,555,555,555,555,-261,555,555,555,555,555,555,555,555,555,555,555,555,-261
-261,-282,-282,-282,-282,-282,-282,-282,-282,-282,-282,-282,-282,-282,-282,-282,-282,-282,-282,-282,-282,-282,-282,-282,-282,-282,-282,-282,-282,-282,-282,-219,555,555,555,555,555,555,555,555,555,555,555,555,-261
-261,-124,-125,-125,-125,-125,-125,-125,-125,-125,-125,-125,-125,-125,-125,-125,-125,-125,-125,-125,-125,-125,-125,-125,-125,-125,-125,-125,-125,-125,126,127,555,555,555,555,555,555,555,555,555,555,555,555,-261
-261,-147,-148,-148,-148,-148,-148,-148,-148,-148,-148,-148,-148,-148,-148,-148,-148,-148,-148,-148,-148,-148,-148,-148,-148,-148,-148,-148,-148,-148,149,150,555,555,555,555,555,555,555,555,555,555,555,555,-261
-261,-170,-171,-171,-171,-171,-171,-171,-171,-171,-171,-171,-171,-171,-171,-171,-171,-171,-171,-171,-171,-171,-171,-171,-171,-171,-171,-171,-171,-171,-172,-173,555,555,555,555,555,555,555,555,555,555,555,555,-261
-261,555,555,555,555,555,555,555,555,555,555,555,555,555,555,555,555,555,555,555,555,555,555,555,555,555,555,555,555,555,555,555,555,555,555,555,555,555,555,555,555,555,555,555,-261
-261,555,555,555,555,555,555,555,555,555,555,555,555,555,555,555,555,555,555,555,555,555,555,555,555,555,555,555,555,555,555,555,555,555,555,555,555,555,555,555,555,555,555,555,-261
-261,555,555,555,555,555,555,555,555,555,555,555,555,555,555,555,555,555,555,555,555,555,555,555,555,555,555,555,555,555,555,555,555,555,555,555,555,555,555,555,555,555,555,555,-261
-261,555,555,555,555,555,555,555,555,555,555,555,555,555,555,555,555,555,555,555,555,555,555,555,555,555,555,555,555,555,555,555,555,555,555,555,555,555,555,555,555,555,555,555,-261
-261,555,555,555,555,555,555,555,555,555,555,555,555,555,555,555,555,555,555,555,555,555,555,555,555,555,555,555,555,555,555,555,555,555,555,555,555,555,555,555,555,555,555,555,-261
-261,555,555,555,555,555,555,555,555,555,555,555,555,555,555,555,555,555,555,555,555,555,555,555,555,555,555,555,555,555,555,555,555,555,555,555,555,555,555,555,555,555,555,555,-261
-261,555,555,555,555,555,555,555,555,555,555,555,555,555,555,555,555,555,555,555,555,555,555,555,555,555,555,555,555,555,555,555,555,555,555,555,555,555,555,555,555,555,555,555,-261
-261,555,555,555,555,555,555,555,555,555,555,555,555,555,555,555,555,555,555,555,555,555,555,555,555,555,555,555,555,555,555,555,555,555,555,555,555,555,555,555,555,555,555,555,-261
-261,555,555,555,555,555,555,555,555,555,555,555,555,555,555,555,555,555,555,555,555,555,555,555,555,555,555,555,555,555,555,555,555,555,555,555,555,555,555,555,555,555,555,555,-261
-261,555,555,555,555,555,555,555,555,555,555,555,555,555,555,555,555,555,555,555,555,555,555,555,555,555,555,555,555,555,555,555,555,555,555,555,555,555,555,555,555,555,555,555,-261
210,-282,-282,-282,-282,-282,-282,-282,-282,-282,-282,-282,-282,-282,-282,-282,-282,-282,-282,-282,-282,-282,-282,-282,-282,-282,-282,-282,-282,-282,-282,-282,-282,-282,-282,-282,-282,-282,-282,-282,-282,-282,-282,-282,-219
