45
45
195,282,282,282,282,282,282,282,282,282,282,282,282,282,282,282,282,282,282,282,282,282,282,282,282,282,282,282,282,282,282,282,282,282,282,282,282,282,282,282,282,282,282,282,196
-1,124,125,125,125,125,125,125,125,125,125,125,125,125,125,125,125,125,125,125,125,126,125,125,125,125,125,125,125,125,126,125,125,125,125,125,125,125,125,125,126,125,125,127,-1
-1,147,148,148,148,148,148,148,148,148,148,148,148,148,148,148,148,148,148,148,148,149,148,148,148,148,148,148,148,148,149,148,148,148,148,148,148,148,148,148,149,148,148,150,-1
-1,170,171,171,171,171,171,171,171,171,171,171,171,171,171,171,171,171,171,171,171,172,171,171,171,171,171,171,171,171,172,171,171,171,171,171,171,171,171,171,172,171,171,173,-1
-1,1,1,1,1,1,1,1,1,1,1,1,1,1,1,1,1,1,1,1,1,1,1,1,1,1,1,1,1,1,1,1,1,1,1,1,1,1,1,1,1,1,1,1,-1
-1,1,1,1,1,1,1,1,1,1,1,1,1,1,1,1,1,1,1,1,1,1,1,1,1,1,1,1,1,1,1,1,1,1,1,1,1,1,1,1,1,1,1,1,-1
-1,1,1,1,1,1,1,1,1,1,1,1,1,1,1,1,1,1,1,1,1,1,1,1,1,1,1,1,1,1,1,1,1,1,1,1,1,1,1,1,1,1,1,1,-1
-1,1,1,1,1,1,1,1,1,1,1,1,1,1,1,1,1,1,1,1,1,1,1,1,1,1,1,1,1,1,1,1,1,1,1,1,1,1,1,1,1,1,1,1,-1
-1,1,1,1,1,195,236,190,190,190,190,190,190,190,190,190,196,1,1,1,1,1,195,236,236,236,236,236,236,236,236,196,1,1,1,1,1,1,1,1,1,1,1,1,-1
-1,1,1,1,1,77,124,125,126,126,126,126,126,125,126,127,-1,1,1,1,1,1,-1,124,125,126,125,126,125,126,127,-1,1,1,1,1,1,1,1,1,1,1,1,1,-1
-1,1,1,1,1,77,147,148,149,149,149,149,149,148,149,150,-1,1,1,1,1,1,-1,147,148,149,148,149,148,149,150,-1,1,1,1,1,1,1,1,1,1,1,1,1,-1
-1,1,1,1,1,77,170,171,172,172,172,172,172,171,172,-173,-1,1,1,1,1,1,-1,170,171,172,171,172,171,172,173,-1,1,1,1,1,1,1,1,1,1,1,1,1,-1
-1,1,1,1,1,77,1,1,1,1,1,1,1,1,1,1,-1,1,1,1,1,1,-1,1,1,1,1,1,1,1,1,-1,1,1,1,1,1,1,1,1,1,1,1,1,-1
-1,1,1,1,1,77,1,1,1,1,1,1,1,1,1,1,218,190,190,190,190,190,219,1,1,1,1,1,1,1,1,-1,1,1,1,1,1,1,1,1,1,1,1,1,-1
-1,1,1,1,1,77,1,1,1,1,1,1,1,1,1,1,124,126,126,126,126,126,127,1,1,1,1,1,1,1,1,-1,1,1,1,1,1,1,1,1,1,1,1,1,-1
-1,1,1,1,1,77,1,1,1,1,1,1,1,1,1,1,147,149,149,149,149,149,150,1,1,1,1,1,1,1,1,-1,1,1,1,1,1,1,1,1,1,1,1,1,-1
-1,1,1,1,1,77,1,1,1,1,1,1,1,1,1,1,170,172,172,172,172,172,173,1,1,1,1,1,1,1,1,-1,1,1,1,1,1,1,1,1,1,1,1,1,-1
-1,1,1,1,1,77,1,1,1,1,1,1,1,1,1,1,1,1,1,1,1,1,1,1,1,1,1,1,1,1,1,-1,1,1,1,1,1,1,1,1,1,1,1,1,-1
-1,190,190,190,190,211,1,1,1,1,1,1,1,1,1,1,1,1,1,1,1,1,1,1,1,1,1,1,1,1,1,-1,1,1,1,1,1,1,1,1,1,1,1,1,-1
-1,124,125,125,126,127,1,1,1,1,54,1,1,1,1,1,1,1,1,1,1,1,1,1,54,1,1,1,1,1,1,-1,1,1,1,1,1,1,1,1,1,1,1,1,-1
-1,147,148,148,149,150,1,1,1,1,77,1,1,1,1,1,1,1,1,1,1,1,1,1,77,1,1,1,1,1,1,-1,1,1,1,1,1,1,1,1,1,1,1,1,-1
-1,170,171,171,172,173,1,1,1,1,77,1,1,1,1,1,1,1,1,1,1,1,1,1,77,1,1,1,1,1,1,-1,1,1,1,1,1,1,1,1,1,1,1,1,-1
-1,1,1,1,1,1,1,1,1,1,77,1,1,1,1,1,1,1,1,1,1,1,1,1,77,1,1,1,1,1,1,-1,1,1,1,1,1,1,1,1,1,1,1,1,-1
-1,1,1,1,1,1,1,1,1,1,34,144,144,144,144,144,144,144,144,144,144,144,144,144,35,1,1,1,1,1,1,-1,1,1,1,1,1,1,1,1,1,1,1,1,-1
-1,1,1,1,1,1,1,1,1,1,147,148,148,148,148,148,148,148,148,148,148,148,148,149,150,1,1,1,1,1,1,-1,1,1,1,1,1,1,1,1,1,1,1,1,-1
-1,1,1,1,1,1,1,1,1,1,170,171,171,171,171,171,171,171,171,171,171,171,171,172,173,1,1,1,1,1,1,-1,1,1,1,1,1,1,1,1,1,1,1,1,-1
-1,1,1,1,1,1,1,1,1,1,1,1,1,1,1,1,1,1,1,1,1,1,1,1,1,1,1,1,1,1,1,-1,1,1,1,1,1,1,1,1,1,1,1,1,-1
-1,1,1,1,1,1,1,1,1,1,1,1,1,1,1,1,1,1,1,1,1,1,1,1,1,1,1,1,1,1,1,-1,1,1,1,1,1,1,1,1,1,1,1,1,-1
-1,1,1,1,1,1,1,1,1,1,1,1,1,1,1,1,1,1,1,1,1,1,1,1,1,1,1,1,1,1,1,-1,1,1,1,1,1,1,1,1,1,1,1,1,-1
-1,1,1,1,1,1,1,1,1,1,1,1,1,1,1,1,1,1,1,1,1,1,1,1,1,1,1,1,1,1,1,-1,1,1,1,1,1,1,1,1,1,1,1,1,-1
-1,282,282,282,282,282,282,282,282,282,282,282,282,282,282,282,282,282,282,282,282,282,282,282,282,282,282,282,282,282,282,219,1,1,1,1,1,1,1,1,1,1,1,1,-1
-1,124,125,125,125,125,125,125,125,125,125,125,125,125,125,125,125,125,125,125,125,125,125,125,125,125,125,125,125,125,126,127,1,1,1,1,1,1,1,1,1,1,1,1,-1
-1,147,148,148,148,148,148,148,148,148,148,148,148,148,148,148,148,148,148,148,148,148,148,148,148,148,148,148,148,148,149,150,1,1,1,1,1,1,1,1,1,1,1,1,-1
-1,170,171,171,171,171,171,171,171,171,171,171,171,171,171,171,171,171,171,171,171,171,171,171,171,171,171,171,171,171,172,173,1,1,1,1,1,1,1,1,1,1,1,1,-1
-1,1,1,1,1,1,1,1,1,1,1,1,1,1,1,1,1,1,1,1,1,1,1,1,1,1,1,1,1,1,1,1,1,1,1,1,1,1,1,1,1,1,1,1,-1
-1,1,1,1,1,1,1,1,1,1,1,1,1,1,1,1,1,1,1,1,1,1,1,1,1,1,1,1,1,1,1,1,1,1,1,1,1,1,1,1,1,1,1,1,-1
-1,1,1,1,1,1,1,1,1,1,1,1,1,1,1,1,1,1,1,1,1,1,1,1,1,1,1,1,1,1,1,1,1,1,1,1,1,1,1,1,1,1,1,1,-1
-1,1,1,1,1,1,1,1,1,1,1,1,1,1,1,1,1,1,1,1,1,1,1,1,1,1,1,1,1,1,1,1,1,1,1,1,1,1,1,1,1,1,1,1,-1
-1,1,1,1,1,1,1,1,1,1,1,1,1,1,1,1,1,1,1,1,1,1,1,1,1,1,1,1,1,1,1,1,1,1,1,1,1,1,1,1,1,1,1,1,-1
-1,1,1,1,1,1,1,1,1,1,1,1,1,1,1,1,1,1,1,1,1,1,1,1,1,1,1,1,1,1,1,1,1,1,1,1,1,1,1,1,1,1,1,1,-1
-1,1,1,1,1,1,1,1,1,1,1,1,1,1,1,1,1,1,1,1,1,1,1,1,1,1,1,1,1,1,1,1,1,1,1,1,1,1,1,1,1,1,1,1,-1
-1,1,1,1,1,1,1,1,1,1,1,1,1,1,1,1,1,1,1,1,1,1,1,1,1,1,1,1,1,1,1,1,1,1,1,1,1,1,1,1,1,1,1,1,-1
-1,1,1,1,1,1,1,1,1,1,1,1,1,1,1,1,1,1,1,1,1,1,1,1,1,1,1,1,1,1,1,1,1,1,1,1,1,1,1,1,1,1,1,1,-1
-1,1,1,1,1,1,1,1,1,1,1,1,1,1,1,1,1,1,1,1,1,1,1,1,1,1,1,1,1,1,1,1,1,1,1,1,1,1,1,1,1,1,1,1,-1
210,282,282,282,282,282,282,282,282,282,282,282,282,282,282,282,282,282,282,282,282,282,282,282,282,282,282,282,282,282,282,282,282,282,282,282,282,282,282,282,282,282,282,282,219
