30
30
-3,-144,-144,-144,-144,-144,-144,-144,-144,-144,-144,-144,-144,-144,-144,-144,-144,-144,-144,-144,-144,-144,-144,-144,-144,-144,-144,-144,-144,-4
-69,-124,-125,-126,-125,-126,-125,-126,-125,-126,-125,-126,-125,-126,-125,-126,-125,-126,-125,-126,-125,-126,-125,-126,-125,-126,-125,-126,-127,-69
-69,555,555,555,555,555,555,555,555,555,555,555,555,555,555,555,555,555,555,555,555,555,555,555,555,555,555,555,555,-69
-69,555,555,555,555,555,555,555,555,555,555,555,555,555,555,555,555,555,555,555,555,555,555,555,555,555,555,555,555,-69
-69,555,555,555,555,555,555,555,555,555,555,555,555,555,555,555,555,555,555,555,555,555,555,555,555,555,555,555,555,-69
-69,555,555,555,555,555,555,555,555,555,555,555,555,555,555,555,555,555,555,555,555,555,555,555,555,555,555,555,555,-69
-69,555,555,555,555,555,555,555,555,555,555,555,555,555,555,555,555,555,555,555,555,555,555,555,555,555,555,555,555,-69
-69,555,555,555,555,555,555,555,555,555,555,555,555,555,555,555,555,555,555,555,555,555,555,555,555,555,555,555,555,-69
-69,555,555,555,555,555,555,555,555,555,555,555,555,555,555,555,555,555,555,555,555,555,555,555,555,555,555,555,555,-69
-69,-144,-144,-144,-144,-144,-144,-144,4,555,555,555,555,555,555,-46,555,555,555,555,555,-46,555,555,555,555,555,555,555,-69
-69,-124,-125,-126,-125,-125,-126,-127,-69,555,555,555,555,555,555,-69,555,555,555,555,555,-69,555,555,555,555,555,555,555,-69
-69,555,555,555,555,555,555,555,-69,555,555,555,555,555,555,-69,555,555,555,555,555,-69,555,555,555,555,555,555,555,-69
-69,555,555,555,555,555,555,555,-69,555,555,555,555,555,555,-69,555,555,555,555,555,-69,555,555,555,555,555,555,555,-69
-69,555,555,555,555,555,555,555,-69,555,555,555,555,555,555,-69,555,555,555,555,555,-69,555,555,555,555,555,555,555,-69
-69,555,555,555,555,555,555,555,-69,555,555,555,555,555,555,-69,555,555,555,555,555,-69,555,555,555,555,555,555,555,-69
-69,555,555,555,555,555,555,555,-69,555,555,555,555,555,555,-69,555,555,555,555,555,-26,-144,-144,-144,-144,-144,-144,-144,-69
-69,555,555,555,555,555,555,555,-69,555,555,555,555,555,555,-69,555,555,555,555,555,-124,-125,-126,-125,-126,-125,-126,-127,-69
-69,555,555,555,555,555,555,555,-69,555,555,555,555,555,555,-69,555,555,555,555,555,555,555,555,555,555,555,555,555,-69
-69,555,555,555,555,555,555,555,-69,555,555,555,555,555,555,-92,555,555,555,555,555,555,555,555,555,555,555,555,555,-69
-69,555,555,555,555,555,555,555,-92,555,555,555,555,555,555,-123,555,555,555,555,555,555,555,555,555,555,555,555,555,-69
-69,555,555,555,555,555,555,555,-127,555,555,555,555,555,555,555,555,555,555,555,555,555,555,555,555,555,555,555,555,-69
-69,555,555,555,555,555,555,555,555,555,555,555,555,555,555,555,555,555,555,555,555,555,555,555,555,555,555,555,555,-69
-69,555,555,555,555,555,555,555,555,555,555,555,555,555,555,555,555,555,555,555,555,555,555,555,555,555,555,555,555,-69
-69,555,555,555,555,555,555,555,555,555,555,555,555,555,555,-46,555,555,555,555,555,555,555,555,555,555,555,555,555,-69
-69,555,555,555,555,555,555,555,555,555,555,555,555,555,555,-69,555,555,555,555,555,555,555,555,555,555,555,555,555,-69
-69,555,555,555,555,555,555,555,555,555,555,555,555,555,555,-69,555,555,555,555,555,555,555,555,555,555,555,555,555,-69
-69,555,555,555,555,555,555,555,555,555,555,555,555,555,555,-69,555,555,555,555,555,555,555,555,555,555,555,555,555,-69
-69,555,555,555,555,555,555,555,555,555,555,555,555,555,555,-69,555,555,555,555,555,555,555,555,555,555,555,555,555,-69
-69,555,555,555,555,555,555,555,555,555,555,555,555,555,555,-69,555,555,555,555,555,555,555,555,555,555,555,555,555,-69
210,-144,-144,-144,-144,-144,-144,-144,-144,-144,-144,-144,-144,-144,-144,-144,-144,-144,-144,-144,-144,-144,-144,-144,-144,-144,-144,-144,-144,-27
