30
25
-41,-41,-41,-41,-41,-41,-41,-41,-41,-41,-41,-41,-41,-41,-41,-41,-41,-41,-41,-41,-41,-41,-41,-41,-41,-41,-41,-41,-41
-41,0  ,0  ,0  ,0  ,0  ,0  ,0  ,0  ,0  ,0  ,0  ,0  ,0  ,0  ,0  ,0  ,0  ,0  ,0  ,0  ,0  ,0  ,0  ,0  ,0  ,0  ,0  ,-41
-41,0  ,0  ,0  ,0  ,0  ,0  ,0  ,0  ,0  ,0  ,0  ,0  ,0  ,0  ,0  ,0  ,0  ,0  ,0  ,0  ,0  ,0  ,0  ,0  ,0  ,0  ,0  ,-41
-41,0  ,0  ,0  ,0  ,0  ,0  ,0  ,0  ,0  ,0  ,0  ,0  ,0  ,0  ,0  ,0  ,0  ,0  ,0  ,0  ,0  ,0  ,0  ,0  ,0  ,0  ,0  ,-41
-41,0  ,0  ,0  ,-41,-41,0  ,0  ,0  ,-41,-41,-41,0  ,0  ,0  ,-41,-41,-41,-41,-41,-41,-41,-41,-41,-41,0  ,0  ,0  ,-41
-41,0  ,0  ,0  ,-41,-41,0  ,0  ,0  ,-41,-41,-41,0  ,0  ,0  ,-41,-41,-41,-41,-41,-41,-41,-41,-41,-41,0  ,0  ,0  ,-41
-41,0  ,0  ,0  ,-41,-41,0  ,0  ,0  ,-41,-41,-41,0  ,0  ,0  ,-41,-41,-41,-41,-41,-41,-41,-41,-41,-41,0  ,0  ,0  ,-41
-41,0  ,0  ,0  ,0  ,0  ,0  ,0  ,0  ,-41,-41,-41,0  ,0  ,0  ,-41,-41,-41,-41,-41,-41,-41,-41,-41,-41,0  ,0  ,0  ,-41
-41,0  ,0  ,0  ,0  ,0  ,0  ,0  ,0  ,-41,-41,-41,0  ,0  ,0  ,-41,-41,-41,-41,-41,-41,-41,-41,-41,-41,0  ,0  ,0  ,-41
-41,0  ,0  ,0  ,0  ,0  ,0  ,0  ,0  ,-41,-41,-41,0  ,0  ,0  ,-41,-41,-41,-41,-41,-41,-41,-41,-41,-41,0  ,0  ,0  ,-41
-41,0  ,0  ,0  ,-41,-41,0  ,0  ,0  ,-41,-41,-41,0  ,0  ,0  ,-41,-41,-41,-41,-41,-41,-41,-41,-41,-41,0  ,0  ,0  ,-41
-41,0  ,0  ,0  ,-41,-41,0  ,0  ,0  ,-41,-41,-41,0  ,0  ,0  ,-41,-41,-41,-41,-41,-41,-41,-41,-41,-41,0  ,0  ,0  ,-41
-41,0  ,0  ,0  ,-41,-41,0  ,0  ,0  ,-41,-41,-41,0  ,0  ,0  ,-41,-41,-41,-41,-41,-41,-41,-41,-41,-41,0  ,0  ,0  ,-41
-41,0  ,0  ,0  ,-41,-41,0  ,0  ,0  ,-41,-41,-41,0  ,0  ,0  ,-41,-41,-41,-41,-41,-41,-41,-41,-41,-41,0  ,0  ,0  ,-41
-41,0  ,0  ,0  ,-41,-41,0  ,0  ,0  ,-41,-41,-41,0  ,0  ,0  ,-41,-41,-41,-41,-41,-41,-41,-41,-41,-41,0  ,0  ,0  ,-41
-41,0  ,0  ,0  ,-41,-41,0  ,0  ,0  ,-41,-41,-41,0  ,0  ,0  ,-41,-41,-41,-41,-41,-41,-41,-41,-41,-41,0  ,0  ,0  ,-41
-41,0  ,0  ,0  ,-41,-41,0  ,0  ,0  ,-41,-41,-41,0  ,0  ,0  ,-41,-41,-41,-41,-41,-41,-41,-41,-41,-41,0  ,0  ,0  ,-41
-41,0  ,0  ,0  ,-41,-41,0  ,0  ,0  ,-41,-41,-41,0  ,0  ,0  ,-41,-41,-41,-41,-41,-41,-41,-41,-41,-41,0  ,0  ,0  ,-41
-41,0  ,0  ,0  ,-41,-41,0  ,0  ,0  ,-41,-41,-41,0  ,0  ,0  ,-41,-41,-41,-41,-41,-41,-41,-41,-41,-41,0  ,0  ,0  ,-41
-41,0  ,0  ,0  ,-41,-41,0  ,0  ,0  ,-41,-41,-41,0  ,0  ,0  ,-41,-41,-41,-41,-41,-41,-41,-41,-41,-41,0  ,0  ,0  ,-41
-41,0  ,0  ,0  ,-41,-41,0  ,0  ,0  ,-41,-41,-41,0  ,0  ,0  ,-41,-41,-41,-41,-41,-41,-41,-41,-41,-41,0  ,0  ,0  ,-41
-41,0  ,0  ,0  ,0  ,0  ,0  ,0  ,0  ,0  ,0  ,0  ,0  ,0  ,0  ,0  ,0  ,0  ,0  ,0  ,0  ,0  ,0  ,0  ,0  ,0  ,0  ,0  ,-41
-41,0  ,0  ,0  ,0  ,0  ,0  ,0  ,0  ,0  ,0  ,0  ,0  ,0  ,0  ,0  ,0  ,0  ,0  ,0  ,0  ,0  ,0  ,0  ,0  ,0  ,0  ,0  ,-41
-41,0  ,0  ,0  ,0  ,0  ,0  ,0  ,0  ,0  ,0  ,0  ,0  ,0  ,0  ,0  ,0  ,0  ,0  ,0  ,0  ,0  ,0  ,0  ,0  ,0  ,0  ,0  ,-41
-41,-41,-41,-41,-41,-41,-41,-41,-41,-41,-41,-41,-41,-41,-41,-41,-41,-41,-41,-41,-41,-41,-41,-41,-41,-41,-41,-41,-41