30
30
-3,-144,-144,-144,-144,-144,-144,-144,-144,-144,-144,-144,-144,-144,-144,-144,-144,-144,-144,-144,-144,-144,-144,-144,-144,-144,-144,-144,-144,-4
-69,-124,-125,-126,-125,-126,-125,-126,-125,-126,-125,-126,-125,-126,-125,-126,-125,-126,-125,-126,-125,-126,-125,-126,-125,-126,-125,-126,-127,-69
-69,555,555,555,555,555,555,555,555,555,555,555,555,555,555,555,555,555,555,555,555,555,555,555,555,555,555,555,555,-69
-69,555,555,555,555,555,555,555,555,555,555,555,555,555,555,555,555,555,555,555,555,555,555,555,555,555,555,555,555,-69
-69,555,555,555,555,555,555,555,555,555,555,555,555,555,555,555,555,555,555,555,555,555,555,555,555,555,555,555,555,-69
-69,555,555,555,555,555,555,555,555,555,555,555,555,555,555,555,555,555,555,555,555,555,555,555,555,555,555,555,555,-69
-69,555,555,555,555,555,555,555,555,555,555,555,555,555,555,555,555,555,555,555,555,555,555,555,555,555,555,555,555,-69
-69,555,555,555,555,555,555,555,555,555,555,555,555,555,555,555,555,555,555,555,555,555,555,555,555,555,555,555,555,-69
-69,555,555,555,555,555,555,555,555,555,555,555,555,555,555,555,555,555,555,555,555,555,555,555,555,555,555,555,555,-69
-69,555,555,555,555,555,555,555,555,555,555,555,555,555,555,555,555,555,555,555,555,555,555,555,555,555,555,555,555,-69
-69,555,555,555,555,555,555,555,555,555,555,555,555,555,555,555,555,555,555,555,555,555,555,555,555,555,555,555,555,-69
-69,555,555,555,555,555,555,555,555,555,555,555,555,555,555,555,555,555,555,555,555,555,555,555,555,555,555,555,555,-69
-69,555,555,555,555,555,555,555,555,555,555,555,555,555,555,555,555,555,555,555,555,555,555,555,555,555,555,555,555,-69
-69,-144,-144,-144,-144,-144,-144,-144,-144,-144,-144,-144,-12,555,555,555,555,555,555,555,555,555,555,555,555,555,555,555,555,-69
-69,-124,-125,-126,-125,-126,-125,-126,-125,-126,-125,-126,-77,555,555,555,555,555,555,555,555,555,555,555,555,555,555,555,555,-69
-69,555,555,555,555,555,555,555,555,555,555,555,-77,555,555,555,555,555,555,555,555,555,555,555,555,555,555,555,555,-69
-69,555,555,555,555,555,555,555,555,555,555,555,-77,555,555,555,555,555,555,555,555,555,555,555,555,555,555,555,555,-69
-69,555,555,555,555,555,555,555,555,555,555,555,-77,555,555,555,555,555,555,555,555,555,555,555,555,555,555,555,555,-69
-69,555,555,555,555,555,555,555,555,555,555,555,-26,-144,-144,-144,-144,-144,-144,-144,-144,-144,-144,-144,-145,555,555,555,555,-69
-69,555,555,555,555,555,555,555,555,555,555,555,-124,-125,-126,-125,-126,-125,-126,-125,-126,-125,-125,-126,-127,555,555,555,555,-69
-69,555,555,555,555,555,555,-46,555,555,555,555,555,555,555,555,555,555,555,555,555,555,555,555,555,555,555,555,555,-69
-69,555,555,555,555,555,555,-69,555,555,555,555,555,555,555,555,555,555,555,555,555,555,555,555,555,555,555,555,555,-69
-69,555,555,555,555,555,555,-69,555,555,555,555,555,555,555,555,555,555,555,555,555,555,555,555,555,555,555,555,555,-69
-69,555,555,555,555,555,555,-69,555,555,555,555,555,555,555,555,555,555,555,555,555,555,555,555,555,555,555,555,555,-69
-69,555,555,555,555,555,555,-69,555,555,555,555,555,555,555,555,555,555,555,555,555,555,555,555,555,555,555,555,555,-69
-69,555,555,555,555,555,555,-69,555,555,555,555,555,555,555,555,555,555,555,555,555,555,555,555,555,555,555,555,555,-69
-69,555,555,555,555,555,555,-69,555,555,555,555,555,555,555,555,555,555,555,555,555,555,555,555,555,555,555,555,555,-69
-69,555,555,555,555,555,555,-69,555,555,555,555,555,555,555,555,555,555,555,555,555,555,555,555,555,555,555,555,555,-69
-69,555,555,555,555,555,555,-69,555,555,555,555,555,555,555,555,555,555,555,555,555,555,555,555,555,555,555,555,555,-69
-26,-144,-144,-144,-144,-144,-144,-144,-144,-144,-144,-144,-144,-144,-144,-144,-144,-144,-144,-144,-144,-144,-144,-144,-144,-144,-144,-144,-144,-27
